10100111100100010
10100100000010100
11100111100001000
10100100000001000
10100111100001000