00111111111
00000000001
10101011101
10101010001
10111111111
10001000001
10101011101
10101010001
11101011111
1000000000
1111111110
