00111111111
00000010101
10111110101
10000010001
10101110111
10100000001
10111010101
10101010101
10101111101
10000010001
11111111101