001111111111111111111
000000001000101010001
101111101010101010101
100010000010000000101
111111101011111110111
100000101000100010001
101011111010101111101
101000100010000010001
111010101011111011101
100010101000001010001
101111111010111011101
100000001010100000101
101110101111101110101
101000101000100010101
101011111110111011101
101010100000001010001
101110101111111011111
101000000010101000001
101111101110101111101
100000000000000000001
111111111111111111101
